ﾋﾟｺﾋﾟｺﾏｰﾁ=ﾌﾛﾘｵｸﾞﾗﾌｨｰ
ﾌｧｰｽﾄｵｰﾀﾞｰ=ﾕﾘｲｶ
ﾌｧｰｽﾄﾄﾞﾘｯﾌﾟ=ﾌｧｯｼﾈｰｼｮﾝ
ﾌｧﾝﾀｼﾞｱﾗｯﾃ=ｱｽﾄﾛﾅﾅ
ﾌｧﾝﾄﾑﾏｲﾝﾄﾞ=ﾗﾝﾗﾝﾄﾞﾘｰﾑ
ﾌｨﾙﾑｶｯｼｰ=ﾖｺｽｶﾖｰｺ
ﾌｪｲｸｽﾘｰﾊﾟｰ=ﾄﾞﾚｯｼｰﾏﾀﾞﾑ
ﾌﾕﾉｴﾙｽｷｰ=ｶﾞﾝﾊﾟｳﾀﾞｰｾﾞﾗﾁﾝ
ﾌﾟﾘﾌﾟﾘﾃｨﾃｨ=ﾎﾟﾌﾟﾘﾝ
ﾌﾞﾘﾝｸﾞｲｯﾄｵﾝ=ﾍﾞﾙﾘﾝﾌﾞﾙｰ
ﾌﾟﾙｰｸﾎﾞｰｹﾞﾝ=ﾐﾘｵﾝﾁｬﾝｽ
ﾌﾟﾙｰﾌﾏｽｶﾗ=ﾐｽﾃﾘｱｽｾﾚﾌﾞ
ﾌﾚｯｼｭｼｮｯﾄ=ｱｼﾀﾏﾆｱｰﾅ
ﾌﾞﾛﾄﾞｳｪｲｽﾞ=ﾍﾞﾘｰﾌｨｰﾙﾄﾞ
ﾎﾜｲﾄｽﾉｰ=ｵｸﾞﾘﾅﾘﾝ
ﾐｰﾑｾﾝｽ=ﾊﾟﾙﾅｼｱﾝ
ﾐﾘﾀﾘｰｶﾞｰﾙ=ｽｺｰﾙﾐｭｰｼﾞｯｸ
ﾐﾙｸﾌﾞﾚｯﾄﾞ=ｼｰｼｰｶﾞｰﾙ
ﾑｼﾉｼﾗｾ=ｶｼｽｳｰﾛﾝ
ﾒｲｸｷｬﾗﾒﾙ=ｵﾈｽﾄﾘｰﾗｳﾞ
ﾒｲﾋﾞｰｱｲ=ｹﾞｰﾑﾌﾟﾗﾝ
ﾒﾓﾘｰｸﾛｯｸ=ﾓﾝﾄﾞﾘｱﾝﾙｯｸ
ﾓｱｱﾁｰﾌﾞﾒﾝﾄ=ｵｸﾗﾎﾏﾐｷｻｰ
ﾓｰﾀｰﾌﾞﾚｲｶｰ=ｱｽｷｰｱｰﾄ
ﾖｲﾉﾕｷﾔﾅｷﾞ=ｶﾚﾝﾄﾄﾞﾗｲﾌﾞ
ﾖﾛｺﾋﾞﾉｳﾀ=ｽﾍﾟｼｬﾙﾎﾞｰﾅｽ
ﾗｲﾄﾌﾞﾛｯｻﾑ=ﾋﾞﾀｰﾀﾝｼﾞｪﾘﾝ
ﾘﾄﾙﾀﾞｰﾑ=ﾍﾞｯｷｰ
ﾙﾅｱﾘｽ=ﾐｽﾊﾅｺ
ﾛｱｺﾝﾁｪﾙﾝ=ﾋﾟｱﾂｰﾋﾟｱ
ﾛｲﾔﾙﾋﾞｯﾃ=ｴｰｼﾞｬﾏｲｶ
ﾛｼﾞｶﾙｼﾝｷﾝｸﾞ=ﾃﾞﾓﾈﾀﾌﾞﾝｷｯﾄ
ﾜｰﾙﾄﾞﾀｲﾑｽ=ﾙﾙｰﾌﾞ
ｱｰｹｰﾄﾞｸｲｰﾝ=ﾌｧｰｽﾄﾁｮｲｽ
ｱｲﾑﾎｰﾑ=ﾗﾌﾞﾎﾟｰｼｮﾝ
ｱｸｱｼｬﾝﾃｨｰ=ﾌｧﾝﾃﾞｰｼｮﾝ
ｱｸｾｽﾏｯﾌﾟ=ﾊｽｷｰﾄﾚﾓﾛ
ｱｼﾝﾒﾄﾘｰ=ﾜﾝﾎﾟｲﾝﾄﾏｰｸ
ｱﾆｵﾝｷﾞｬｯﾌﾟ=ﾚｼﾞｪﾝﾄﾞｵﾌﾞｻﾞﾅﾄﾞｩ
ｱﾋﾞｽﾏﾙﾗｳﾞｧｰ=ｼｭﾝｶｼｭｳﾄｳ
ｱﾙｶｼﾖﾝ=ﾌﾟﾘﾝｾｽﾃﾞｲｼﾞｰ
ｲｰﾗｲｻﾞ=ﾅﾋﾞｨ
ｲｴﾛｰｽｰﾂ=ｶﾏﾁﾝｶｯﾄ
ｳﾞｧｲｵﾊｰﾄ=ﾁﾔﾎﾔ
ｳﾞｧﾙﾊﾗｸｲｰﾝ=ﾉｰﾙｯｸﾊﾟｽ
ｳｨﾙﾛｯｸ=ﾁｭｰﾘｯﾌﾟﾗｲﾝ
ｳﾏｶﾞｱｳｶﾗ=ﾁｰﾌﾟｼｯｸ
ｳﾙﾄﾗｻﾌﾞﾏﾘﾝ=ｼｸﾞﾅﾙﾚｯﾄﾞ
ｴﾀｰﾅﾙﾌｫｰｽ=ｼｰﾏﾘﾝ
ｴﾒﾗﾙﾄﾞﾏｻｷ=ｺﾞﾙﾃﾞｨﾛｯｸｽ
ｴﾝｼﾞｪﾙｼｪﾘｰ=ﾏｰﾒｲﾄﾞﾊｰﾌﾟ
ｴﾝｼﾞﾆｱﾍﾞｲ=ｼｰｻﾞｯﾄｶﾞｰﾙ
ｵﾌﾀｯｸﾙ=ﾄﾞﾛﾜｰｽﾞ
ｵﾙﾀﾅﾃｨﾌﾞ=ｵｷﾄﾞｷｽﾄﾘｰﾄ
ｶﾉﾝﾒﾛﾃﾞｨ=ｵﾄﾒﾉﾜﾙﾂ
ｷｬﾊﾞﾙﾘｰｼﾝｸﾞ=ﾍﾟｲﾝﾌﾙﾓｰﾒﾝﾄ
ｷｬﾘｰｽﾃｯﾌﾟ=ﾃﾞｨｽｺﾃｨｰｸ
ｸｲﾝｱﾗﾍﾞﾙﾄ=ﾌﾙｰﾂﾄｯﾋﾟﾝｸﾞ
ｸﾞﾗｽｸﾞﾛｽ=ｷｯﾁｭ
ｸﾞﾗﾌﾞｱﾊﾞｲﾄ=ﾍﾞｯﾄﾕｱﾌﾞｰﾂ
ｸﾞﾗﾝﾄﾞｵｰﾌﾟﾝ=ｼﾅﾓﾝﾄﾞﾛｯﾌﾟ
ｸﾘｱﾌｫﾚｽﾄ=ﾄﾏﾄﾋﾟｭｰﾚ
ｸﾘｯﾌﾟｸﾘｯﾋﾟｰ=ｼﾍﾞﾘﾔ
ｸﾞﾛｳﾗｲﾄ=ｼﾞﾝﾗﾐｰ
ｹｱﾎﾟｰﾄ=ﾄﾞﾗｲｱﾝﾄﾞｸｰﾙ
ｺｲﾉﾋﾅｷﾞｸ=ﾜﾝﾀﾞｰｽﾎﾟｯﾄ
ｺｲﾉﾜﾙﾂ=ｼｬﾄﾞｳｷﾃｨ
ｺｰﾙﾏｲﾅﾝﾊﾞｰ=ｳﾞｧﾆﾃｨｰﾌｪｱ
ｺｺﾅｯﾂｶﾞｰﾙ=ﾐﾆｯﾂﾘﾋﾟｰﾀｰ
ｻｰﾌｨﾝｻﾝﾃﾞｲ=ｸﾚｰﾋﾞｼﾞｮﾝ
ｻﾏｰﾊﾚｰｼｮﾝ=ﾌｨｯﾄﾚｵﾀｰﾄﾞ
ｻﾙｻﾗｯﾃ=ｽｰﾊﾟｰｽｶｳﾄ
ｻﾝｾｯﾄﾏｲﾔ=ｲﾀﾘｱﾝﾊﾟｾﾘ
ｻﾝﾊﾞｶﾌｪ=ﾏﾘﾝｼﾞｬｲﾌﾞ
ｼｸﾞﾅﾙｷｬｯﾁ=ｵｰﾁｬｰﾄﾞﾊｳｽ
ｼｭｶﾞｰﾚｰﾄﾞﾙ=ｽｷｯﾌﾟﾋﾞｯﾄ
ｼﾞｮｯｸﾛｯｶｰ=ﾍﾟﾊﾟｰﾐﾝﾄﾌﾞﾙｰ
ｼﾝｸﾛｼｽﾀｰ=ﾊｰﾓﾅｲ
ｼﾝﾌｫﾆｱｴﾘｰ=ﾌﾟﾘｸｯｸ
ｽｸﾗﾑﾏｽﾀｰ=ﾏｲﾝﾄﾞｳｪｰﾌﾞ
ｽｽﾞﾉﾈﾁﾘﾘ=ﾏﾏﾁｬﾘ
ｽﾌﾟﾘｳﾑﾏﾘｰ=ｽﾍﾟｰｽｷｰﾊﾟｰ
ｽﾏｲﾙﾄﾞﾛｯﾌﾟ=ﾚﾓﾝﾐﾙｸ
ｽﾗｲﾄﾞｿｰｻｰ=ｵｯｹｰﾊﾞｰﾃﾞｨｰ
ｾﾘﾉﾊﾅ=ｱｯﾁｯﾁｱｰﾁ
ｾﾚｽｱｰｽ=ﾌﾟﾘｰﾂｽｶｰﾄ
ｾﾝﾀｰﾗﾌﾞﾘｰ=ﾑｽﾒｸﾞﾐ
ｿﾙﾃｨｼｬｯｸ=ﾊﾟｯﾋﾟﾝｽ
ｿﾛﾐｭｰﾄｿﾝｸﾞ=ﾀﾞｰｸｻｲﾄﾞﾑｰﾝ
ﾀﾞﾝﾁｪｯｸ=ﾋﾞｼﾞｭｱﾙｺﾝﾃｽﾄ
ﾃｨｱﾙﾐﾅ=ｱｰﾝﾄﾞﾒﾃﾞｨｱ
ﾄﾞｰﾀｰﾗｲﾄ=ｼﾙﾊﾞｰｻﾝ
ﾄﾗｲﾌﾟｯｼｭ=ｴﾝﾄﾞﾚｽﾍﾞｯﾄ
ﾅｰｽﾎﾜｲﾄ=ﾌｧﾝｼｰｼｮｯﾌﾟ
ﾅｲﾄｱﾛｰﾝ=ｸﾗｼｰﾓｰﾄﾞ
ﾉｰﾌﾞﾚｽﾒﾄﾞﾚｰ=ﾜｲﾝｴﾁｹｯﾄ
ﾊｲｳｴｽﾄ=ｾｸｼｰﾋﾞｰﾑ
ﾊｲﾗｳﾞｧﾋｯﾄ=ﾊﾙｻｷｺﾍﾞﾆ
ﾊﾛｳｨﾝﾊﾟｰﾃｨ=ﾚｶﾞｼｰｵﾌﾞｱｰｽ
ﾈｵｲﾝﾊﾟﾙｽ=ﾗﾌﾞﾚｸﾁｬｰ